20x20
22
BottomLeft.png 4
empty.png 1
FloorWFenceShad.png 21
ThreeWayUp.png 5
FloorWOGateShad.png 15
FloorWShad.png 11
ThreeWayDown.png 18
Side.png 12
Floor.png 16
emptyDebug.png 0
GateClosed.png 10
ground.png 2
TopRight.png 6
BottomRight.png 17
ThreeWayLeft.png 7
FloorWCGateShad.png 13
FourWay.png 19
wall.png 3
Front.png 20
ThreeWayRight.png 14
TopLeft.png 8
GateOpened.png 9
5 19 19 19 19 19 19 19 19 19 19 19 19 19 19 19 19 19 19 19 
5 16 16 16 16 16 16 16 16 16 16 16 16 16 16 16 16 16 16 19 
5 16 16 16 16 16 16 16 16 16 16 16 16 16 16 16 16 16 16 19 
5 16 16 16 16 16 16 16 16 16 16 16 16 16 16 16 16 16 16 19 
5 16 16 16 16 16 16 16 16 16 16 16 16 16 16 16 16 16 16 19 
5 16 16 16 16 16 16 16 16 16 16 16 16 16 16 16 16 16 16 19 
5 16 16 16 16 16 16 16 16 16 16 16 16 16 16 16 16 16 16 19 
5 16 16 16 16 16 16 16 16 16 16 16 16 16 16 16 16 16 16 19 
5 16 16 16 16 16 16 16 16 16 16 16 16 16 16 16 16 16 16 19 
19 16 16 16 16 16 16 16 16 16 16 16 16 16 16 16 16 16 16 19 
19 16 16 16 16 16 16 16 16 16 16 16 16 16 16 16 16 16 16 19 
19 16 16 16 16 16 16 16 16 16 16 16 16 16 16 16 16 16 16 19 
19 16 16 16 16 16 16 16 16 16 16 16 16 16 16 16 16 16 16 19 
5 16 16 16 16 16 16 16 16 16 16 16 16 16 16 16 16 16 16 19 
5 16 16 16 16 16 16 16 16 16 16 16 16 16 16 16 16 16 16 19 
5 16 16 16 16 16 16 16 16 16 16 16 16 16 16 16 16 16 16 19 
5 16 16 16 16 16 16 16 16 16 16 16 16 16 16 16 16 16 16 19 
5 16 16 16 16 16 16 16 16 16 16 16 16 16 16 16 16 16 16 19 
5 16 16 16 16 16 16 16 16 16 16 16 16 16 16 16 16 16 16 19 
5 19 19 18 19 19 19 19 19 19 19 19 19 18 18 18 19 19 19 19 