20x20
13
empty.png 2
spawn.png 8
emptyDebug.png 1
ground.png 5
ground(1).png 0
groundWall.png 4
exit.png 7
ground(3).png 10
realWall3d.png 11
wall.png 6
ground(2).png 12
badlogic.jpg 9
3dwallshadow.png 3
6 6 6 6 6 6 6 6 6 6 6 6 6 6 6 6 6 6 6 6 
6 5 5 5 5 5 5 5 5 5 5 5 5 5 5 5 5 5 5 6 
6 5 5 5 5 5 5 5 5 5 5 5 5 5 5 5 5 5 5 6 
6 5 5 5 5 5 5 5 5 5 5 5 5 5 5 5 5 5 5 6 
6 5 5 5 5 5 5 5 5 5 5 5 5 5 5 5 5 5 5 6 
6 5 5 5 5 5 5 5 5 5 5 5 5 5 5 5 5 5 5 6 
6 5 5 5 5 5 5 5 5 5 5 5 5 5 5 5 5 5 5 6 
6 5 5 5 5 5 5 5 5 5 5 5 5 5 5 5 5 5 5 6 
6 5 5 5 5 5 5 5 5 5 5 5 5 5 5 5 5 5 5 6 
6 5 5 5 5 5 5 5 5 5 5 5 5 5 5 5 5 5 5 6 
6 5 5 5 5 5 5 5 5 5 5 5 5 5 5 5 5 5 5 2 
6 5 5 5 5 5 5 5 5 5 5 5 5 5 5 5 5 5 5 6 
6 5 5 5 5 5 5 5 5 5 5 5 5 5 5 5 5 5 5 6 
6 5 5 5 5 5 5 5 5 5 5 5 5 5 5 5 5 5 5 6 
6 5 5 5 5 5 5 5 5 5 5 5 5 5 5 5 5 5 5 6 
6 5 5 5 5 5 5 5 5 5 5 5 5 5 5 5 5 5 5 6 
6 5 5 5 5 5 5 5 5 5 5 5 5 5 5 5 5 5 5 6 
6 5 5 5 5 5 5 5 5 5 5 5 5 5 5 5 5 5 5 6 
6 5 5 5 5 5 5 5 5 5 5 5 5 5 5 5 5 5 5 6 
6 6 6 6 6 6 6 6 6 6 6 6 6 6 6 6 6 6 6 6 