20x20
7
exit.png 4
empty.png 1
spawn.png 5
wall.png 3
emptyDebug.png 0
ground.png 2
badlogic.jpg 6
0 0 0 0 0 0 0 0 0 0 0 0 0 0 0 0 0 0 0 0 
0 0 0 0 0 0 0 0 0 0 0 0 0 0 0 3 0 0 0 0 
0 0 0 0 0 0 0 0 0 0 0 0 0 0 3 0 0 0 0 0 
0 0 0 0 0 0 0 0 0 0 0 0 0 3 3 0 0 0 0 0 
0 0 0 0 0 0 0 0 0 0 0 0 3 3 0 0 0 0 0 0 
0 0 0 0 0 0 3 3 3 0 0 3 3 0 0 0 0 0 0 0 
0 0 0 0 0 3 3 0 3 3 3 3 0 0 0 0 0 0 0 0 
0 0 0 0 0 3 0 0 0 0 3 3 0 0 0 0 0 0 0 0 
0 0 0 0 0 3 0 0 0 0 0 3 0 0 0 0 0 0 0 0 
0 0 0 0 0 0 3 0 0 0 0 3 0 0 0 0 0 0 0 0 
0 0 0 0 0 0 3 3 0 0 3 3 0 0 0 0 0 0 0 0 
0 0 0 0 0 0 3 0 0 0 3 0 0 0 0 0 0 0 0 0 
0 0 0 0 0 0 3 0 0 3 3 0 0 0 0 0 0 0 0 0 
0 0 0 0 0 0 3 0 3 3 0 0 0 0 0 0 0 0 0 0 
0 0 0 0 0 0 3 3 3 0 0 0 0 0 0 0 0 0 0 0 
0 0 0 0 0 0 3 3 0 0 0 0 0 0 0 0 0 0 0 0 
0 0 0 0 0 0 0 0 0 0 0 0 0 0 0 0 0 0 0 0 
0 0 0 0 0 0 0 0 0 0 0 0 0 0 0 0 0 0 0 0 
0 0 0 0 0 0 0 0 0 0 0 0 0 0 0 0 0 0 0 0 
0 0 0 0 0 0 0 0 0 0 0 0 0 0 0 0 0 0 0 0 